çom	gz
çons	gz
ão	pt
ões	pt
ável	pt
áveis	pt
ível	pt
íveis	pt
gia	pt
gias	pt
ciones	es
ción	es
gía	es
gías	es
ción	gl
cións	gl
xía	gl
xías	gl
eur	fr
tion	fr
tion	en
ing	en
ak	eu
